111111
1P0001
101C01
101001
1E01C1
111111